1111111111111111111
100100C1100000000C1
1000110011101100001
1P00000000000101011
10000EC000001100111
1010111001100000001
10100100C0011000101
10100100011111101C1
1C0C000000000000001
1111111111111111111
